WWWWWWWWWWWW
W1111111111W
W10P00T00E1W
W1000000001W
W100H000T01W
W1111111111W
WWWWWWWWWWWW